0 0 0 0 0
0 1 2 7 1
0 1 0 4 1
1 0 0 10 1
2 3 1 12 1
0 0 5 15 1
1 2 1 19 1
1 3 2 23 1
1 4 3 3 1
1 5 4 15 1
1 56 44 40 1